{
    "width": 10,
    "height": 8,
    "cells": [
      [2, 0, 0, 0, 0, 0, 0, 0, 0, 0],
      [1, 0, 0, 0, 0, 0, 0, 0, 0, 0],
      [1, 1, 1, 1, 1, 1, 0, 0, 0, 0],
      [0, 0, 0, 0, 0, 1, 0, 0, 0, 0],
      [0, 0, 0, 0, 0, 1, 1, 1, 1, 0],
      [0, 0, 0, 0, 0, 0, 0, 0, 1, 0],
      [0, 0, 0, 0, 0, 0, 0, 0, 1, 0],
      [0, 0, 0, 0, 0, 0, 0, 0, 1, 3]
    ]
}